
{
"Level": 
    {
    "layer2": 
        [[  0,  0,  0,  0,  0,  0,  0,  0,  0,  0,  0,  0,  0,  0,  0],
         [  0,  0,  0,  0,  0,  0,  0,  0,  0,  0,  0,  0,  0,  0,  0],
         [  0,  0,  0,  0,  0,  0,  0,  0,  0,  0,  0,  0,  0,  0,  0],
         [  0,  0,  0,  0,  0,  0,  0,  0,  0,  0,  0,  0,  0,  0,  0],
         [  0,  0,  0,  0,  0,  0,  0,  0,  0,  0,  0,  0,  0,  0,  0],
         [  0,  0,  0,  0,  0, 19,  0,  0,  0,  0,  0,  0,  0,  0,  0],
         [  0,  0,  0,  0,  0,  0,  0,  0,  0,  0,  0,  0,  0,  0,  0],
         [  0,  0,  0,  0,  0, 20,  0,  0, 22,  0,  0,  0,  0,  0,  0],
         [  0,  0,  0,  0,  0,  0,  0,  0,  0,  0,  0,  0,  0,  0,  0],
         [  0,  0,  0,  0,  0,  0,  0,  0,  0,  0,  0,  0,  0,  0,  0],
         [  0,  0,  0,  0,  0,  0,  0,  0,  0,  0,  0,  0,  0,  0,  0],
         [  0,  0,  0,  0,  0,  0,  0,  0,  0,  0,  0,  0,  0,  0,  0],
         [  0,  0,  0,  0,  0,  0,  0,  0,  0,  0,  0,  0,  0,  0,  0],
         [  0,  0,  0,  0,  0,  0,  0,  0,  0,  0,  0,  0,  0,  0,  0],
         [  0,  0,  0,  0,  0,  0,  0,  0,  0,  0,  0,  0,  0,  0,  0]],
    "layer4": 
        [[  0,  0,  0,  0,  0,  0,  0,  0,  0,  0,  0,  0,  0,  0,  0],
         [  0,  0,  0,  0,  0,  0,  0,  0,  0,  0,  0,  0,  0,  0,  0],
         [  0,  0,  0,  0,  0,  0,  0,  0,  0,  0,  0,  0,  0,  0,  0],
         [  0,  0,  0,  0,  0,  0,  0,  0,  0,  0,  0,  0,  0,  0,  0],
         [  0,  0,  0,  0,  0,  0,  0,  0,  0,  0,  0,  0,  0,  0,  0],
         [  0,  0,  0,  0,  0, 18,  0,  0,  0,  0,  0,  0,  0,  0,  0],
         [  0,  0,  0,  0,  0, 21,  0,  0,  0,  0,  0,  0,  0,  0,  0],
         [  0,  0,  0,  0,  0,  0,  0,  0,  0,  0,  0,  0,  0,  0,  0],
         [  0,  0,  0,  0,  0,  0,  0,  0,  0,  0,  0,  0,  0,  0,  0],
         [  0,  0,  0,  0,  0,  0,  0,  0,  0,  0,  0,  0,  0,  0,  0],
         [  0,  0,  0,  0,  0,  0,  0, 24,  0,  0,  0,  0,  0,  0,  0],
         [  0,  0,  0,  0,  0,  0,  0,  0,  0,  0,  0,  0,  0,  0,  0],
         [  0,  0,  0,  0,  0,  0,  0,  0,  0,  0,  0,  0,  0,  0,  0],
         [  0,  0,  0,  0,  0,  0,  0,  0,  0,  0,  0,  0,  0,  0,  0],
         [  0,  0,  0,  0,  0,  0,  0,  0,  0,  0,  0,  0,  0,  0,  0]],
    "colision": 
        [[  0,  0,  0,  0,  0,  0,  0,  0,  0,  0,  0,  0,  0,  0,  0],
         [  0,  0,  0,  0,  0,  0,  0,  0,  0,  0,  0,  0,  0,  0,  0],
         [  0,  0,  0,  0,  0,  0,  0,  0,  0,  0,  0,  0,  0,  0,  0],
         [  0,  0,  0,  0,  0,  0,  0,  0,  0,  0,  0,  0,  0,  0,  0],
         [  0,  0,  0,  0,  0,  0,  0,  0,  0,  0,  0,  0,  0,  0,  0],
         [  0,  0,  0,  0,  1,  1,  1,  1,  1,  1,  0,  0,  0,  0,  0],
         [  0,  0,  0,  0,  1,  0,  0,  0,  0,  1,  0,  0,  0,  0,  0],
         [  0,  0,  0,  0,  1,  1,  0,  0,  1,  1,  0,  0,  0,  0,  0],
         [  0,  0,  0,  0,  1,  0,  0,  0,  0,  1,  0,  0,  0,  0,  0],
         [  0,  0,  0,  0,  1,  0,  0,  0,  0,  1,  0,  0,  0,  0,  0],
         [  0,  0,  0,  0,  1,  1,  1,  0,  1,  1,  0,  0,  0,  0,  0],
         [  0,  0,  0,  0,  1,  1,  1,  1,  1,  1,  0,  0,  0,  0,  0],
         [  0,  0,  0,  0,  0,  0,  0,  0,  0,  0,  0,  0,  0,  0,  0],
         [  0,  0,  0,  0,  0,  0,  0,  0,  0,  0,  0,  0,  0,  0,  0],
         [  0,  0,  0,  0,  0,  0,  0,  0,  0,  0,  0,  0,  0,  0,  0]],
    "charas":  [""],
    "tileImage": "img/tile.png",
    "tiles": 
        {
        "10":  [  9, 10],
        "2":  [ 10,  7],
        "8":  [ 10,  9],
        "1":  [  9,  7],
        "6":  [ 11,  8],
        "16":  [  9, 12],
        "3":  [ 11,  7],
        "20":  [ 11, 13],
        "25":  [ 11, 16],
        "7":  [  9,  9],
        "0":  [  0,  0],
        "5":  [ 10,  8],
        "14":  [ 10, 11],
        "21":  [  9, 14],
        "13":  [  9, 11],
        "11":  [ 10, 10],
        "19":  [ 10, 13],
        "22":  [ 10, 14],
        "4":  [  9,  8],
        "18":  [  9, 13],
        "9":  [ 11,  9],
        "15":  [ 11, 11],
        "23":  [ 11, 14],
        "12":  [ 11, 10],
        "24":  [ 11, 15],
        "17":  [ 10, 12]
        },
    "levelName": "playerhouse",
    "eventsType": 
        {
        "1":  [  0,  1],
        "2":  [  1,  0]
        },
    "eventsActions": 
        {
        "1": 
            [["fadeOut","blackFadeOut;keepEffect"],
             ["teleport","11;11;beach"],
             ["fadeIn","blackFadeIn;doNotKeep"]],
        "2": 
            [["showText","Got a sword!"],
             ["addItem","sword"],
             ["changeTile","23;layer2;keep;remove;8;7;this"]]
        },
    "tilesAnimated": 
        {
        },
    "layer1": 
        [[ 16, 16, 16, 16, 16, 16, 16, 16, 16, 16, 16, 16, 16, 16, 16],
         [ 16, 16, 16, 16, 16, 16, 16, 16, 16, 16, 16, 16, 16, 16, 16],
         [ 16, 16, 16, 16, 16, 16, 16, 16, 16, 16, 16, 16, 16, 16, 16],
         [ 16, 16, 16, 16, 16, 17, 17, 17, 17, 16, 16, 16, 16, 16, 16],
         [ 16, 16, 16, 16, 16, 13,  7,  8, 13, 16, 16, 16, 16, 16, 16],
         [ 16, 16, 16, 16, 16, 14, 10, 11, 14, 16, 16, 16, 16, 16, 16],
         [ 16, 16, 16, 16, 16,  0,  3,  1,  4, 16, 16, 16, 16, 16, 16],
         [ 16, 16, 16, 16, 16,  1,  6,  2,  2, 16, 16, 16, 16, 16, 16],
         [ 16, 16, 16, 16, 16,  2,  2,  2,  5, 16, 16, 16, 16, 16, 16],
         [ 16, 16, 16, 16, 16,  4,  2, 15,  5, 16, 16, 16, 16, 16, 16],
         [ 16, 16, 16, 16, 16, 16, 16, 25, 16, 16, 16, 16, 16, 16, 16],
         [ 16, 16, 16, 16, 16, 16, 16, 16, 16, 16, 16, 16, 16, 16, 16],
         [ 16, 16, 16, 16, 16, 16, 16, 16, 16, 16, 16, 16, 16, 16, 16],
         [ 16, 16, 16, 16, 16, 16, 16, 16, 16, 16, 16, 16, 16, 16, 16],
         [ 16, 16, 16, 16, 16, 16, 16, 16, 16, 16, 16, 16, 16, 16, 16]],
    "events": 
        [[  0,  0,  0,  0,  0,  0,  0,  0,  0,  0,  0,  0,  0,  0,  0],
         [  0,  0,  0,  0,  0,  0,  0,  0,  0,  0,  0,  0,  0,  0,  0],
         [  0,  0,  0,  0,  0,  0,  0,  0,  0,  0,  0,  0,  0,  0,  0],
         [  0,  0,  0,  0,  0,  0,  0,  0,  0,  0,  0,  0,  0,  0,  0],
         [  0,  0,  0,  0,  0,  0,  0,  0,  0,  0,  0,  0,  0,  0,  0],
         [  0,  0,  0,  0,  0,  0,  0,  0,  0,  0,  0,  0,  0,  0,  0],
         [  0,  0,  0,  0,  0,  0,  0,  0,  0,  0,  0,  0,  0,  0,  0],
         [  0,  0,  0,  0,  0,  0,  0,  0,  2,  0,  0,  0,  0,  0,  0],
         [  0,  0,  0,  0,  0,  0,  0,  0,  0,  0,  0,  0,  0,  0,  0],
         [  0,  0,  0,  0,  0,  0,  0,  0,  0,  0,  0,  0,  0,  0,  0],
         [  0,  0,  0,  0,  0,  0,  0,  1,  0,  0,  0,  0,  0,  0,  0],
         [  0,  0,  0,  0,  0,  0,  0,  0,  0,  0,  0,  0,  0,  0,  0],
         [  0,  0,  0,  0,  0,  0,  0,  0,  0,  0,  0,  0,  0,  0,  0],
         [  0,  0,  0,  0,  0,  0,  0,  0,  0,  0,  0,  0,  0,  0,  0],
         [  0,  0,  0,  0,  0,  0,  0,  0,  0,  0,  0,  0,  0,  0,  0]]
    }
}