
{
"Level": 
    {
    "tiles": 
        {
        "24":  [  2,  7],
        "25":  [  0,  8],
        "26":  [  1,  8],
        "27":  [  2,  8],
        "20":  [  1,  6],
        "21":  [  2,  6],
        "22":  [  0,  7],
        "23":  [  1,  7],
        "28":  [  0,  9],
        "29":  [  1,  9],
        "4":  [  0,  1],
        "8":  [  1,  2],
        "59":  [  3, 11],
        "58":  [  5, 10],
        "55":  [  5,  9],
        "54":  [  4,  9],
        "57":  [  4, 10],
        "56":  [  3, 10],
        "51":  [  4,  8],
        "50":  [  3,  8],
        "53":  [  3,  9],
        "52":  [  5,  8],
        "115":  [  1, 19],
        "114":  [  0, 19],
        "88":  [  6, 13],
        "89":  [  7, 13],
        "111":  [  2, 17],
        "110":  [  1, 17],
        "113":  [  1, 18],
        "112":  [  0, 18],
        "82":  [  6, 11],
        "83":  [  7, 11],
        "80":  [  4, 14],
        "81":  [  8, 10],
        "86":  [  7, 12],
        "87":  [  8, 12],
        "84":  [  8, 11],
        "85":  [  6, 12],
        "3":  [  2,  0],
        "7":  [  0,  2],
        "108":  [  2, 16],
        "109":  [  0, 17],
        "102":  [  8, 17],
        "103":  [  6, 18],
        "100":  [  6, 17],
        "101":  [  7, 17],
        "106":  [  0, 16],
        "107":  [  1, 16],
        "104":  [  7, 18],
        "105":  [  8, 18],
        "39":  [  2, 12],
        "38":  [  1, 12],
        "33":  [  2, 10],
        "32":  [  1, 10],
        "31":  [  0, 10],
        "30":  [  2,  9],
        "37":  [  0, 12],
        "36":  [  2, 11],
        "35":  [  1, 11],
        "34":  [  0, 11],
        "60":  [  4, 11],
        "61":  [  5, 11],
        "62":  [  3, 12],
        "63":  [  4, 12],
        "64":  [  5, 12],
        "65":  [  3, 13],
        "66":  [  4, 13],
        "67":  [  5, 13],
        "68":  [  6,  7],
        "69":  [  7,  7],
        "2":  [  1,  0],
        "6":  [  2,  1],
        "99":  [  8, 16],
        "98":  [  7, 16],
        "91":  [  6, 14],
        "90":  [  8, 13],
        "93":  [  8, 14],
        "92":  [  7, 14],
        "95":  [  7, 15],
        "94":  [  6, 15],
        "97":  [  6, 16],
        "96":  [  8, 15],
        "11":  [  1,  3],
        "10":  [  0,  3],
        "13":  [  0,  4],
        "12":  [  2,  3],
        "15":  [  2,  4],
        "14":  [  1,  4],
        "17":  [  1,  5],
        "16":  [  0,  5],
        "19":  [  0,  6],
        "18":  [  2,  5],
        "48":  [  4,  7],
        "49":  [  5,  7],
        "46":  [  2, 15],
        "47":  [  3,  7],
        "44":  [  0, 15],
        "45":  [  1, 15],
        "42":  [  2, 13],
        "43":  [  0, 14],
        "40":  [  0, 13],
        "41":  [  1, 13],
        "1":  [  0,  0],
        "5":  [  1,  1],
        "9":  [  2,  2],
        "77":  [  6, 10],
        "76":  [  8,  9],
        "75":  [  7,  9],
        "74":  [  6,  9],
        "73":  [  8,  8],
        "72":  [  7,  8],
        "71":  [  6,  8],
        "70":  [  8,  7],
        "79":  [  3, 14],
        "78":  [  7, 10]
        },
    "charas": 
        [["bear",  7,  9],
         ["skeleton",  9, 18],
         ["bunny",  7,  1],
         ["bunny", 10,  2],
         ["bunny2",  3,  0],
         ["bunny", 14,  1],
         ["sack",  3, 14]],
    "tileImage": "img/tile.png",
    "tilesAnimated": 
        {
        "20": 
            [[  1,  6],
             [  4,  6],
             [  7,  6],
             [ 10,  6]],
        "21": 
            [[  2,  6],
             [  5,  6],
             [  8,  6],
             [ 11,  6]],
        "43": 
            [[  0, 14],
             [  1, 14],
             [  2, 14],
             [  1, 14]],
        "1": 
            [[  0,  0],
             [  3,  0],
             [  6,  0],
             [  9,  0]],
        "3": 
            [[  2,  0],
             [  5,  0],
             [  8,  0],
             [ 11,  0]],
        "2": 
            [[  1,  0],
             [  4,  0],
             [  7,  0],
             [ 10,  0]],
        "5": 
            [[  1,  1],
             [  4,  1],
             [  7,  1],
             [ 10,  1]],
        "4": 
            [[  0,  1],
             [  3,  1],
             [  6,  1],
             [  9,  1]],
        "7": 
            [[  0,  2],
             [  3,  2],
             [  6,  2],
             [  9,  2]],
        "6": 
            [[  2,  1],
             [  5,  1],
             [  8,  1],
             [ 11,  1]],
        "9": 
            [[  2,  2],
             [  5,  2],
             [  8,  2],
             [ 11,  2]],
        "8": 
            [[  1,  2],
             [  4,  2],
             [  7,  2],
             [ 10,  2]],
        "11": 
            [[  1,  3],
             [  4,  3],
             [  7,  3],
             [ 10,  3]],
        "10": 
            [[  0,  3],
             [  3,  3],
             [  6,  3],
             [  9,  3]],
        "13": 
            [[  0,  4],
             [  3,  4],
             [  6,  4],
             [  9,  4]],
        "12": 
            [[  2,  3],
             [  5,  3],
             [  8,  3],
             [ 11,  3]],
        "15": 
            [[  2,  4],
             [  5,  4],
             [  8,  4],
             [ 11,  4]],
        "14": 
            [[  1,  4],
             [  4,  4],
             [  7,  4],
             [ 10,  4]],
        "17": 
            [[  1,  5],
             [  4,  5],
             [  7,  5],
             [ 10,  5]],
        "16": 
            [[  0,  5],
             [  3,  5],
             [  6,  5],
             [  9,  5]],
        "19": 
            [[  0,  6],
             [  3,  6],
             [  6,  6],
             [  9,  6]],
        "18": 
            [[  2,  5],
             [  5,  5],
             [  8,  5],
             [ 11,  5]]
        },
    "levelName": "Beach",
    "layer2": 
        [[  0,  0,  0,  0,  0,  0,  0,  0,  0,  0,  0,  0,  0,  0,  0,  0,  0,  0,  0,  0,  0,  0,  0,  0,  0],
         [  0,  0,  0,  0,  0,  0,  0,  0,  0,  0,  0,  0,  0,  0,  0,  0,  0,  0,  0,  0,  0,  0,  0,  0,  0],
         [  0,  0,  0,  0,  0,  0,  0,  0,  0,  0,  0,  0,  0,  0,  0,  0,  0,  0,  0,  0,  0,  0,  0,  0,  0],
         [  0,  0,  0,  0,  0,  0,  0,  0,  0,  0,  0,  0,  0,  0,  0,  0,  0,  0,  0,  0,  0,  0,  0,  0,  0],
         [  0,  0,  0,  0,  0,  0,  0,  0,  0,  0,  0,  0,  0,  0,  0,  0,  0,  0,  0,  0,  0,  0,  0,  0,  0],
         [  0,  0,  0,  0,  0,  0,  0,  0,  0,  0,  0,  0,  0,  0,  0,  0,  0,  0,  0,  0,  0,  0,  0,  0,  0],
         [  0,  0,  0,  0,  0,  0,  0,  0,  0,  0,  0,  0,  0,  0,  0,  0,  0,  0,  0,  0,  0,  0,  0,  0,  0],
         [  0,  0,  0,  0,  0,  0,  0,  0,  0,  0,  0,  0,  0,  0,  0,  0,  0,  0,  0,  0,  0,  0,  0,  0,  0],
         [  0,  0,  0,  0,  0,  0,  0,  0,  0,  0,  0,  0,  0,  0,  0,  0,  0,  0,  0,  0,  0,  0,  0,  0,  0],
         [  0,  0,  0,  0,  0,  0,  0,  0,  0,  0,  0,  0,  0,  0,  0,  0,  0,  0,  0,  0,  0,  0,  0,  0,  0],
         [  0,  0,  0,  0,  0,  0,  0,  0,  0,  0,  0,  0,  0,  0,  0,  0,  0,  0,  0,  0,  0,  0,  0,  0,  0],
         [  0,  0,  0,  0,  0,  0,  0,  0,  0,  0,  0,  0,  0,  0,  0,  0,  0,  0,  0,  0,  0,  0,  0,  0,  0],
         [  0,  0,  0,  0,  0,  0,  0,  0,  0,  0,  0,  0,  0,  0,  0,  0,  0,  0,  0,  0,  0,  0,  0,  0,  0],
         [  0,  0,  0,  0,  0,  0,  0,  0,  0,  0,  0,  0,  0,  0,  0,  0,  0,  0,  0,  0,  0,  0,  0,  0,  0],
         [  0,  0,  0,  0,  0,  0,  0,  0,  0,  0,  0,  0,  0,  0,  0,  0,  0,  0,  0,  0,  0,  0,  0,  0,  0],
         [  0,  0,  0,  0,  0,  0,  0,  0,  0,  0,  0,  0,  0,  0,  0,  0,  0,  0,  0,  0,  0,  0,  0,  0,  0],
         [  0,  0,  0,  0,  0,  0,  0,  0,  0,  0,  0,  0,  0,  0,  0,  0,  0,  0,  0,  0,  0,  0,  0,  0,  0],
         [  0,  0,  0,  0,  0,  0,  0,  0,  0,  0,  0,  0,  0,  0,  0,  0,  0,  0,  0,  0,  0,  0,  0,  0,  0],
         [  0,  0,  0,  0,  0,  0,  0,  0,  0,  0,  0,  0,  0,  0,  0,  0,  0,  0,  0,  0,  0,  0,  0,  0,  0],
         [  0,  0,  0,  0,  0,  0,  0,  0,  0,  0,  0,  0,  0,  0,  0,  0,  0,  0,  0,  0,  0,  0,  0,  0,  0],
         [  0,  0,  0,  0,  0,  0,  0,  0,  0,  0,  0,  0,  0,  0,  0,  0,  0,  0,  0,  0,  0,  0,  0,  0,  0],
         [  0,  0,  0,  0,  0,  0,  0,  0,  0,  0,  0,  0,  0,  0,  0,  0,  0,  0,  0,  0,  0,  0,  0,  0,  0],
         [  0,  0,  0,  0,  0,  0,  0,  0,  0,  0,  0,  0,  0,  0,  0,  0,  0,  0,  0,  0,  0,  0,  0,  0,  0],
         [  0,  0,  0,  0,  0,  0,  0,  0,  0,  0,  0,  0,  0,  0,  0,  0,  0,  0,  0,  0,  0,  0,  0,  0,  0],
         [  0,  0,  0,  0,  0,  0,  0,  0,  0,  0,  0,  0,  0,  0,  0,  0,  0,  0,  0,  0,  0,  0,  0,  0,  0]],
    "layer1": 
        [[ 73, 22, 70, 22, 22, 22, 22, 23, 23, 77, 77, 77, 45, 24, 50, 60, 61, 19, 20, 19, 20, 19, 20, 19, 20],
         [ 78, 72, 77, 22, 23, 23, 77, 23, 23, 23, 23, 44, 45, 23, 50, 80, 64, 11, 17, 16, 17, 16, 17, 16, 17],
         [ 72, 72, 72, 69, 69, 70, 23, 23, 22, 23, 23, 23, 23, 45, 53, 61, 67,  4, 20, 19, 20, 19, 20, 19, 20],
         [ 78, 89, 78, 72, 72, 73, 70, 23, 23, 23, 23, 23, 47, 48, 48, 64,  1, 14, 17, 16, 17, 16, 17, 16, 17],
         [ 92, 82, 88, 78, 72, 72, 73, 23, 44, 23, 23,  5,  0, 51, 61, 67,  4, 19, 20, 19, 20, 19, 20, 19, 20],
         [ 82, 83, 81, 78, 78, 78, 73, 77, 24, 23, 23, 23, 23, 80, 64, 54,  4, 16, 17, 16, 17, 16, 17, 16, 17],
         [ 82, 84, 88, 78, 78, 72, 76, 23, 23, 23, 31, 32, 33, 51, 65, 43,  4, 19, 20, 19, 20, 19, 20, 19, 20],
         [ 98, 98, 88, 78, 72, 75, 77, 46, 23, 23, 34, 35, 36, 51, 80, 73,  4, 16, 17, 16, 17, 16, 17, 16, 17],
         [108,108,109, 78, 75, 70, 68, 23, 23, 23, 37, 38, 39, 51, 51, 58,  4, 19, 20, 19, 20, 19, 20, 19, 20],
         [108,111,101, 78, 72, 75, 76, 44, 44, 23, 40, 41, 42, 51, 51, 80, 21, 16, 17, 16, 17, 16, 17, 16, 17],
         [111,101,106, 78, 77, 77, 76, 23, 24, 23, 23, 53, 50, 51, 51, 61,  7, 11, 20, 19, 20, 19, 20, 19, 20],
         [101,106, 89, 78, 77, 76, 23, 44, 23, 24, 23, 47, 50, 61, 63, 64, 77,  7, 11, 16, 17, 16, 17, 16, 17],
         [106, 89, 72, 77, 77, 77, 77, 70, 23, 24, 23, 50, 80, 64, 66, 67, 49, 77,  4, 17, 20, 19, 20, 19, 20],
         [ 89, 72, 56, 57, 58, 24, 22, 77, 24, 23, 44, 50, 80, 67, 65, 79, 52, 23,  4, 16, 17, 16, 17, 16, 17],
         [ 72, 77, 59, 51, 60, 23, 77, 72, 77, 23, 23, 50, 51, 58, 53, 54, 55, 70,  4, 17, 20, 19, 20, 19, 20],
         [ 77, 23, 53, 54, 55, 77, 72, 77, 23, 23, 23, 53, 50, 51, 58, 44, 71, 73,  7, 11, 17, 16, 17, 16, 17],
         [ 47, 49, 23, 77, 23, 77, 77, 24, 22, 23, 23, 47, 50, 60, 61, 46, 77, 76, 44,  4, 20, 19, 20, 19, 20],
         [ 53, 55, 23, 47, 48, 49, 44, 23, 23, 22, 23, 50, 80, 63, 64, 44, 44, 44, 23,  4, 17, 16, 17, 16, 17],
         [ 23, 44, 22, 50, 51, 52, 23,  0,  0, 24, 22, 50, 80, 66, 67, 49, 23, 23, 23,  4, 20, 19, 20, 19, 20],
         [ 23, 22, 23, 53, 54, 55, 23, 31, 33, 23, 22, 50, 51, 65, 79, 52, 77, 44, 23,  4, 17, 16, 17, 16, 17],
         [ 58, 23, 22, 23, 22, 23, 44, 34, 36, 22, 23,  0,  0, 51, 58, 49, 22, 23,  1, 14, 20, 19, 20, 19, 20],
         [ 63, 56, 57, 58, 22, 47, 48, 37, 39, 23, 22, 31, 33, 51, 51, 52, 23,  1, 14, 19, 17, 16, 17, 16, 17],
         [ 59, 59, 51, 61, 23, 50, 60, 40, 42, 23, 44, 37, 39, 54, 54, 55,  1, 14, 17, 16, 20, 19, 20, 19, 20],
         [ 62, 62, 63, 64, 57, 57, 58, 53, 55, 22, 23, 40, 42, 15, 15, 15, 21, 19, 20, 19, 17, 16, 17, 16, 17],
         [ 60, 65, 66, 67, 66, 63, 61, 58, 22, 56, 57, 58, 23, 22, 23,  1, 14, 16, 17, 16, 20, 19, 20, 19, 20]],
    "layer4": 
        [[  0,  0,  0,  0,  0,  0,  0,  0,  0,  0,  0,  0,  0,  0,  0,  0,  0,  0,  0,  0,  0,  0,  0,  0,  0],
         [  0,  0,  0,  0,  0,  0,  0,  0,  0,  0,  0,  0,  0,  0,  0,  0,  0,  0,  0,  0,  0,  0,  0,  0,  0],
         [  0,  0,  0,  0,  0,  0,  0,  0,  0,  0,  0,  0,  0,  0,  0,  0,  0,  0,  0,  0,  0,  0,  0,  0,  0],
         [  0,  0,  0,  0,  0,  0,  0,  0,  0,  0,  0,  0,  0,  0,  0,  0,  0,  0,  0,  0,  0,  0,  0,  0,  0],
         [  0,  0,  0,  0,  0,  0,  0,  0,  0,  0, 25, 26, 27,  0,  0,  0,  0,  0,  0,  0,  0,  0,  0,  0,  0],
         [  0,  0,  0,  0,  0,  0,  0,  0,  0,  0, 28, 29, 30,  0,  0,  0,  0,  0,  0,  0,  0,  0,  0,  0,  0],
         [  0,  0,  0,  0,  0,  0,  0,  0,  0,  0,  0,  0,  0,  0,  0,  0,  0,  0,  0,  0,  0,  0,  0,  0,  0],
         [  0,  0,  0,  0,  0,  0,  0,  0,  0,  0,  0,  0,  0,  0,  0,  0,  0,  0,  0,  0,  0,  0,  0,  0,  0],
         [  0,  0,  0,  0,  0,  0,  0,  0,  0,  0,  0,  0,  0,  0,  0,  0,  0,  0,  0,  0,  0,  0,  0,  0,  0],
         [  0,  0,  0,  0,  0,  0,  0,  0,  0,  0,  0,  0,  0,  0,  0,  0,  0,  0,  0,  0,  0,  0,  0,  0,  0],
         [  0,  0,  0,  0,  0,  0,  0,  0,  0,  0,  0,  0,  0,  0,  0,  0,  0,  0,  0,  0,  0,  0,  0,  0,  0],
         [  0,  0,  0,  0,  0,  0,  0,  0,  0,  0,  0,  0,  0,  0,  0,  0,  0,  0,  0,  0,  0,  0,  0,  0,  0],
         [  0,  0,  0,  0,  0,  0,  0,  0,  0,  0,  0,  0,  0,  0,  0,  0,  0,  0,  0,  0,  0,  0,  0,  0,  0],
         [  0,  0,  0,  0,  0,  0,  0,  0,  0,  0,  0,  0,  0,  0,  0,  0,  0,  0,  0,  0,  0,  0,  0,  0,  0],
         [  0,  0,  0,  0,  0,  0,  0,  0,  0,  0,  0,  0,  0,  0,  0,  0,  0,  0,  0,  0,  0,  0,  0,  0,  0],
         [  0,  0,  0,  0,  0,  0,  0,  0,  0,  0,  0,  0,  0,  0,  0,  0,  0,  0,  0,  0,  0,  0,  0,  0,  0],
         [  0,  0,  0,  0,  0,  0,  0,  0,  0,  0,  0,  0,  0,  0,  0,  0,  0,  0,  0,  0,  0,  0,  0,  0,  0],
         [  0,  0,  0,  0,  0,  0,  0,  0,  0,  0,  0,  0,  0,  0,  0,  0,  0,  0,  0,  0,  0,  0,  0,  0,  0],
         [  0,  0,  0,  0,  0,  0,  0, 25, 27,  0,  0,  0,  0,  0,  0,  0,  0,  0,  0,  0,  0,  0,  0,  0,  0],
         [  0,  0,  0,  0,  0,  0,  0,  0,  0,  0,  0,  0,  0,  0,  0,  0,  0,  0,  0,  0,  0,  0,  0,  0,  0],
         [  0,  0,  0,  0,  0,  0,  0,  0,  0,  0,  0, 25, 27,  0,  0,  0,  0,  0,  0,  0,  0,  0,  0,  0,  0],
         [  0,  0,  0,  0,  0,  0,  0,  0,  0,  0,  0,  0,  0,  0,  0,  0,  0,  0,  0,  0,  0,  0,  0,  0,  0],
         [  0,  0,  0,  0,  0,  0,  0,  0,  0,  0,  0,  0,  0,  0,  0,  0,  0,  0,  0,  0,  0,  0,  0,  0,  0],
         [  0,  0,  0,  0,  0,  0,  0,  0,  0,  0,  0,  0,  0,  0,  0,  0,  0,  0,  0,  0,  0,  0,  0,  0,  0],
         [  0,  0,  0,  0,  0,  0,  0,  0,  0,  0,  0,  0,  0,  0,  0,  0,  0,  0,  0,  0,  0,  0,  0,  0,  0]],
    "eventsActions": 
        {
        "1": 
            [["fadeOut","blackFadeOut;keepEffect"],
             ["teleport","7;9;playerhouse"],
             ["fadeIn","blackFadeIn;doNotKeep"]]
        },
    "colision": 
        [[  0,  0,  0,  0,  0,  0,  0,  0,  0,  0,  0,  0,  0,  0,  0,  1,  1,  1,  1,  1,  1,  1,  1,  1,  1],
         [  0,  0,  0,  0,  0,  0,  0,  0,  0,  0,  0,  0,  0,  0,  0,  0,  1,  0,  1,  1,  1,  1,  1,  1,  1],
         [  0,  0,  0,  0,  0,  0,  0,  0,  0,  0,  0,  0,  0,  0,  0,  1,  1,  0,  1,  1,  1,  1,  1,  1,  1],
         [  0,  0,  0,  0,  0,  0,  0,  0,  0,  0,  0,  0,  0,  0,  0,  1,  0,  1,  1,  1,  1,  1,  1,  1,  1],
         [  0,  0,  0,  0,  0,  0,  0,  0,  0,  0,  0,  0,  0,  0,  1,  1,  0,  1,  1,  1,  1,  1,  1,  1,  1],
         [  0,  0,  0,  0,  0,  0,  0,  0,  0,  0,  1,  1,  1,  0,  1,  0,  0,  1,  1,  1,  1,  1,  1,  1,  1],
         [  0,  0,  0,  0,  0,  0,  0,  0,  0,  0,  1,  1,  1,  0,  1,  0,  0,  1,  1,  1,  1,  1,  1,  1,  1],
         [  0,  0,  0,  0,  0,  0,  0,  0,  0,  0,  1,  1,  1,  0,  0,  1,  0,  1,  1,  1,  1,  1,  1,  1,  1],
         [  0,  0,  0,  0,  0,  0,  0,  0,  0,  0,  1,  1,  1,  0,  0,  1,  0,  1,  1,  1,  1,  1,  1,  1,  1],
         [  0,  0,  0,  0,  0,  0,  0,  0,  0,  0,  1,  0,  1,  0,  0,  0,  1,  1,  1,  1,  1,  1,  1,  1,  1],
         [  0,  0,  0,  0,  0,  0,  0,  0,  0,  0,  0,  0,  0,  0,  0,  1,  0,  0,  1,  1,  1,  1,  1,  1,  1],
         [  0,  0,  0,  0,  0,  0,  0,  0,  0,  0,  0,  0,  0,  1,  1,  1,  0,  0,  0,  1,  1,  1,  1,  1,  1],
         [  0,  0,  0,  0,  0,  0,  0,  0,  0,  0,  0,  0,  0,  1,  1,  1,  0,  0,  0,  1,  1,  1,  1,  1,  1],
         [  0,  0,  1,  1,  1,  0,  0,  0,  0,  0,  0,  0,  0,  1,  0,  0,  0,  0,  0,  1,  1,  1,  1,  1,  1],
         [  0,  0,  1,  0,  1,  0,  0,  0,  0,  0,  0,  0,  0,  1,  0,  0,  0,  0,  0,  1,  1,  1,  1,  1,  1],
         [  0,  0,  0,  0,  0,  0,  0,  0,  0,  0,  0,  0,  0,  0,  1,  0,  0,  0,  0,  0,  1,  1,  1,  1,  1],
         [  0,  0,  0,  0,  0,  0,  0,  0,  0,  0,  0,  0,  0,  1,  1,  0,  0,  0,  0,  0,  1,  1,  1,  1,  1],
         [  0,  0,  0,  0,  0,  0,  0,  0,  0,  0,  0,  0,  0,  1,  1,  0,  0,  0,  0,  0,  1,  1,  1,  1,  1],
         [  0,  0,  0,  0,  0,  0,  0,  0,  0,  0,  0,  0,  0,  1,  1,  0,  0,  0,  0,  0,  1,  1,  1,  1,  1],
         [  0,  0,  0,  0,  0,  0,  0,  1,  1,  0,  0,  0,  0,  1,  0,  0,  0,  0,  0,  0,  1,  1,  1,  1,  1],
         [  1,  0,  0,  0,  0,  0,  0,  1,  1,  0,  0,  0,  0,  0,  1,  0,  0,  0,  0,  0,  1,  1,  1,  1,  1],
         [  1,  1,  1,  1,  0,  0,  0,  1,  1,  0,  0,  1,  1,  0,  0,  0,  0,  0,  0,  1,  1,  1,  1,  1,  1],
         [  1,  1,  1,  1,  0,  0,  1,  1,  1,  0,  0,  1,  1,  0,  0,  0,  0,  0,  1,  1,  1,  1,  1,  1,  1],
         [  1,  1,  1,  1,  1,  1,  1,  0,  0,  0,  0,  1,  1,  0,  0,  0,  0,  1,  1,  1,  1,  1,  1,  1,  1],
         [  1,  1,  1,  1,  1,  1,  1,  1,  0,  1,  1,  1,  0,  0,  0,  0,  0,  1,  1,  1,  1,  1,  1,  1,  1]],
    "eventsType": 
        {
        "1":  [  0,  1]
        },
    "events": 
        [[  0,  0,  0,  0,  0,  0,  0,  0,  0,  0,  0,  0,  0,  0,  0,  0,  0,  0,  0,  0,  0,  0,  0,  0,  0],
         [  0,  0,  0,  0,  0,  0,  0,  0,  0,  0,  0,  0,  0,  0,  0,  0,  0,  0,  0,  0,  0,  0,  0,  0,  0],
         [  0,  0,  0,  0,  0,  0,  0,  0,  0,  0,  0,  0,  0,  0,  0,  0,  0,  0,  0,  0,  0,  0,  0,  0,  0],
         [  0,  0,  0,  0,  0,  0,  0,  0,  0,  0,  0,  0,  0,  0,  0,  0,  0,  0,  0,  0,  0,  0,  0,  0,  0],
         [  0,  0,  0,  0,  0,  0,  0,  0,  0,  0,  0,  0,  0,  0,  0,  0,  0,  0,  0,  0,  0,  0,  0,  0,  0],
         [  0,  0,  0,  0,  0,  0,  0,  0,  0,  0,  0,  0,  0,  0,  0,  0,  0,  0,  0,  0,  0,  0,  0,  0,  0],
         [  0,  0,  0,  0,  0,  0,  0,  0,  0,  0,  0,  0,  0,  0,  0,  0,  0,  0,  0,  0,  0,  0,  0,  0,  0],
         [  0,  0,  0,  0,  0,  0,  0,  0,  0,  0,  0,  0,  0,  0,  0,  0,  0,  0,  0,  0,  0,  0,  0,  0,  0],
         [  0,  0,  0,  0,  0,  0,  0,  0,  0,  0,  0,  0,  0,  0,  0,  0,  0,  0,  0,  0,  0,  0,  0,  0,  0],
         [  0,  0,  0,  0,  0,  0,  0,  0,  0,  0,  0,  1,  0,  0,  0,  0,  0,  0,  0,  0,  0,  0,  0,  0,  0],
         [  0,  0,  0,  0,  0,  0,  0,  0,  0,  0,  0,  0,  0,  0,  0,  0,  0,  0,  0,  0,  0,  0,  0,  0,  0],
         [  0,  0,  0,  0,  0,  0,  0,  0,  0,  0,  0,  0,  0,  0,  0,  0,  0,  0,  0,  0,  0,  0,  0,  0,  0],
         [  0,  0,  0,  0,  0,  0,  0,  0,  0,  0,  0,  0,  0,  0,  0,  0,  0,  0,  0,  0,  0,  0,  0,  0,  0],
         [  0,  0,  0,  0,  0,  0,  0,  0,  0,  0,  0,  0,  0,  0,  0,  0,  0,  0,  0,  0,  0,  0,  0,  0,  0],
         [  0,  0,  0,  0,  0,  0,  0,  0,  0,  0,  0,  0,  0,  0,  0,  0,  0,  0,  0,  0,  0,  0,  0,  0,  0],
         [  0,  0,  0,  0,  0,  0,  0,  0,  0,  0,  0,  0,  0,  0,  0,  0,  0,  0,  0,  0,  0,  0,  0,  0,  0],
         [  0,  0,  0,  0,  0,  0,  0,  0,  0,  0,  0,  0,  0,  0,  0,  0,  0,  0,  0,  0,  0,  0,  0,  0,  0],
         [  0,  0,  0,  0,  0,  0,  0,  0,  0,  0,  0,  0,  0,  0,  0,  0,  0,  0,  0,  0,  0,  0,  0,  0,  0],
         [  0,  0,  0,  0,  0,  0,  0,  0,  0,  0,  0,  0,  0,  0,  0,  0,  0,  0,  0,  0,  0,  0,  0,  0,  0],
         [  0,  0,  0,  0,  0,  0,  0,  0,  0,  0,  0,  0,  0,  0,  0,  0,  0,  0,  0,  0,  0,  0,  0,  0,  0],
         [  0,  0,  0,  0,  0,  0,  0,  0,  0,  0,  0,  0,  0,  0,  0,  0,  0,  0,  0,  0,  0,  0,  0,  0,  0],
         [  0,  0,  0,  0,  0,  0,  0,  0,  0,  0,  0,  0,  0,  0,  0,  0,  0,  0,  0,  0,  0,  0,  0,  0,  0],
         [  0,  0,  0,  0,  0,  0,  0,  0,  0,  0,  0,  0,  0,  0,  0,  0,  0,  0,  0,  0,  0,  0,  0,  0,  0],
         [  0,  0,  0,  0,  0,  0,  0,  0,  0,  0,  0,  0,  0,  0,  0,  0,  0,  0,  0,  0,  0,  0,  0,  0,  0],
         [  0,  0,  0,  0,  0,  0,  0,  0,  0,  0,  0,  0,  0,  0,  0,  0,  0,  0,  0,  0,  0,  0,  0,  0,  0]]
    }
}