
{
"Level": 
    {
    "tiles": 
        {
        "42":  [  0, 19],
        "43":  [  1, 19],
        "49":  [  1, 20],
        "52":  [  4, 20],
        "53":  [  5, 20],
        "24":  [  5,  3],
        "25":  [  0,  4],
        "26":  [  4,  4],
        "27":  [  4,  5],
        "20":  [  1,  3],
        "21":  [  2,  3],
        "22":  [  3,  3],
        "23":  [  4,  3],
        "46":  [  4, 19],
        "47":  [  5, 19],
        "44":  [  2, 19],
        "45":  [  3, 19],
        "28":  [  5,  4],
        "29":  [  1,  4],
        "40":  [  4, 18],
        "41":  [  5, 18],
        "1":  [  1,  0],
        "3":  [  3,  0],
        "2":  [  2,  0],
        "5":  [  5,  0],
        "4":  [  4,  0],
        "7":  [  1,  1],
        "6":  [  0,  1],
        "9":  [  3,  1],
        "8":  [  2,  1],
        "39":  [  3, 18],
        "38":  [  2, 18],
        "32":  [  2, 17],
        "11":  [  5,  1],
        "10":  [  4,  1],
        "13":  [  0,  2],
        "12":  [  1,  2],
        "15":  [  2,  2],
        "14":  [  1,  2],
        "17":  [  4,  2],
        "16":  [  3,  2],
        "19":  [  0,  3],
        "18":  [  5,  2],
        "31":  [  1, 17],
        "30":  [  0, 17],
        "51":  [  3, 20],
        "36":  [  0, 18],
        "35":  [  5, 17],
        "34":  [  4, 17],
        "33":  [  3, 17],
        "37":  [  1, 18],
        "48":  [  0, 20],
        "50":  [  2, 20]
        },
    "charas": 
        [["sack",  4, 12],
         ["bunny",  7,  1],
         ["bunny", 10,  2],
         ["bunny2",  3,  0],
         ["bunny", 17,  0]],
    "tileImage": "img/tile.png",
    "tilesAnimated": 
        {
        "5": 
            [[  0,  5],
             [  1,  5],
             [  2,  5],
             [  3,  5]],
        "29": 
            [[  1,  4],
             [  2,  4],
             [  1,  4],
             [  3,  4]]
        },
    "levelName": "level0",
    "layer2": 
        [[  0,  0,  0,  0,  0,  0,  0,  0,  0,  0,  0,  0, 22, 18, 10,  0, 22, 18,  0,  0],
         [  0, 22, 17, 21,  0,  0,  0,  0,  0,  0,  0,  0, 11, 13, 20, 22, 18,  0,  0,  0],
         [  0, 11,  0, 10,  0,  0,  0,  0,  0,  0,  0, 22, 18, 16, 17, 18,  0,  0,  0,  0],
         [  0, 19, 14, 20,  0,  0,  0,  0,  0,  0,  0, 11,  0,  0,  0,  0,  0,  0,  0,  0],
         [  0,  0,  0,  0,  0,  0,  0,  0,  0,  0,  0, 19, 14, 15,  0,  0,  0,  0,  0,  0],
         [  0,  0,  0,  0,  0, 44,  0,  0,  0,  0,  0,  0,  0, 19, 15,  0,  0,  0,  0,  0],
         [  0,  0,  0, 33,  0, 35,  0,  0,  0,  0,  0,  0,  0,  0, 11,  0,  0,  0,  0,  0],
         [  0,  0,  0, 39,  0, 41,  0,  0,  0,  0,  0,  0,  0,  0, 19, 15,  0,  0,  0,  0],
         [  0,  0,  0, 45,  0, 47,  0,  0,  0,  0,  0,  0,  0,  0,  0, 19, 15,  0,  0,  0],
         [  0,  0,  0,  0,  0,  0,  0,  0,  0, 29,  0,  0,  0,  0,  0,  0, 11,  0,  0,  0],
         [  0,  0,  0,  0,  0,  0,  0,  0,  0,  0,  0,  0,  0,  0,  0,  0, 11,  0,  0,  0],
         [  0, 22, 21,  0,  0,  0,  0,  0, 22,  0, 22, 17, 21,  0,  0,  0, 19, 15,  0,  0],
         [ 17, 18, 16, 21,  0,  0,  0,  0, 38, 22, 18,  0, 16, 21,  0,  0, 22, 18,  0,  0],
         [  0,  0,  0, 16, 21,  0,  0,  0, 44, 11,  0,  0,  0, 10,  0, 22, 18,  0,  0,  0],
         [  0,  0,  0, 13, 20,  0, 33,  0, 35, 19, 15,  0, 13, 20, 22, 18,  0,  0,  0,  0],
         [  0,  0, 13, 20,  0,  0, 39,  0, 41,  0, 19, 15, 16, 21, 11,  0,  0,  0,  0,  0],
         [  0,  0, 16, 21,  0,  0, 45,  0, 47,  0,  0, 19, 14, 20, 11,  0,  0,  0,  0,  0],
         [  0,  0,  0, 16, 17, 21,  0,  0,  0,  0,  0,  0,  0, 22, 18,  0,  0,  0,  0,  0],
         [  0,  0,  0,  0,  0, 16, 17, 21,  0,  0,  0,  0,  0, 11,  0,  0,  0,  0,  0,  0],
         [  0,  0,  0,  0,  0,  0,  0, 10,  0,  0,  0,  0,  0, 11,  0,  0,  0,  0,  0,  0]],
    "layer1": 
        [[  7,  7,  7,  7,  7,  7,  7,  7,  7,  7,  7,  9,  5,  5,  5,  9,  5,  5,  5,  5],
         [  7,  1,  1,  1,  7,  7,  7,  7,  7,  7,  7,  9,  5,  5,  5,  5,  5,  5,  5,  5],
         [  7,  1,  4,  1,  7,  7,  7,  7,  7,  7,  7,  5,  5,  5,  5,  5,  5,  5,  5,  5],
         [  7,  1,  1,  1,  7,  9,  9,  7,  7,  7,  7,  5,  5,  5,  5,  5,  5,  5,  5,  5],
         [  7,  7,  9,  0,  0,  7,  7,  7,  7,  8,  8,  5,  5,  5,  5,  5,  5,  5,  5,  5],
         [  7,  7,  7, 42, 43,  7,  7,  7,  7,  7,  7,  7,  7,  5,  5,  5,  5,  5,  5,  5],
         [  7,  7,  7,  7, 34,  7,  7,  7,  7,  7,  7,  7,  7,  7,  5,  5,  5,  5,  5,  5],
         [  7,  7,  7,  7, 40,  7,  7,  7,  7,  7,  7,  7,  7,  7,  5,  5,  5,  5,  5,  5],
         [  7,  7,  7,  7, 46,  7,  7,  9,  7,  9,  7,  7,  7,  7,  7,  5,  5,  5,  5,  5],
         [  7,  7,  7,  9,  8,  7,  7,  7,  9,  7,  8,  7,  7,  7,  7,  7,  5,  5,  5,  5],
         [  7,  7,  7,  7,  7,  7,  9,  7,  7,  9,  9,  7,  9,  9,  8,  7,  5,  5,  5,  5],
         [  7,  1,  1,  7,  9,  7,  9,  9,  9,  7,  5,  5,  5,  7,  7,  7,  5,  5,  5,  5],
         [  1,  1,  1,  1,  7,  9, 36, 37,  9,  5,  5,  5,  5,  5,  9,  7,  5,  5,  5,  5],
         [  1,  1,  1,  1,  1,  8, 42, 43, 44,  5,  5,  5,  5,  5,  7,  5,  5,  5,  5,  5],
         [  1,  1,  1,  1,  1,  8,  7, 34,  7,  5,  5,  5,  5,  5,  5,  5,  5,  5,  5,  5],
         [  1,  1,  1,  1,  9,  7,  7, 40,  7,  8,  5,  5,  5,  5,  5,  5,  5,  5,  5,  5],
         [  1,  1,  1,  1,  9,  9,  7, 46,  7,  8,  9,  5,  5,  5,  5,  5,  5,  5,  5,  5],
         [  1,  1,  1,  1,  1,  1,  9,  9,  9,  9,  9,  9,  8,  5,  5,  5,  5,  5,  5,  5],
         [  1,  1,  1,  1,  1,  1,  1,  1,  9,  9,  7,  9,  9,  5,  5,  5,  5,  5,  5,  5],
         [  1,  1,  1,  1,  1,  1,  1,  1,  9,  9,  9,  9,  8,  5,  5,  5,  5,  5,  5,  5]],
    "layer4": 
        [[  0,  0,  0,  0,  0,  0,  0,  0,  0,  0,  0,  0,  0,  0,  0,  0,  0,  0,  0,  0],
         [  0,  0,  0,  0,  0,  0,  0,  0,  0,  0,  0,  0,  0,  0,  0,  0,  0,  0,  0,  0],
         [  0,  0,  0,  0,  0,  0,  0,  0,  0,  0,  0,  0,  0,  0,  0,  0,  0,  0,  0,  0],
         [  0,  0,  0,  0,  0,  0,  0,  0,  0,  0,  0,  0,  0,  0,  0,  0,  0,  0,  0,  0],
         [  0,  0,  0, 30, 31, 32,  0,  0,  0,  0,  0,  0,  0,  0,  0,  0,  0,  0,  0,  0],
         [  0,  0,  0,  0,  0,  0,  0,  0,  0,  0,  0,  0,  0,  0,  0,  0,  0,  0,  0,  0],
         [  0,  0,  0,  0,  0,  0,  0,  0,  0,  0,  0,  0,  0,  0,  0,  0,  0,  0,  0,  0],
         [  0,  0,  0,  0,  0,  0,  0,  0,  0,  0,  0,  0,  0,  0,  0,  0,  0,  0,  0,  0],
         [  0,  0,  0,  0,  0,  0,  0,  0,  0,  0,  0,  0,  0,  0,  0,  0,  0,  0,  0,  0],
         [  0,  0,  0,  0,  0,  0,  0,  0,  0,  0,  0,  0,  0,  0,  0,  0,  0,  0,  0,  0],
         [  0,  0,  0,  0,  0,  0,  0,  0,  0,  0,  0,  0,  0,  0,  0,  0,  0,  0,  0,  0],
         [  0,  0,  0,  0,  0,  0, 30, 31, 32,  0,  0,  0,  0,  0,  0,  0,  0,  0,  0,  0],
         [  0,  0,  0,  0,  0,  0,  0,  0,  0,  0,  0,  0,  0,  0,  0,  0,  0,  0,  0,  0],
         [  0,  0,  0,  0,  0,  0,  0,  0,  0,  0,  0,  0,  0,  0,  0,  0,  0,  0,  0,  0],
         [  0,  0,  0,  0,  0,  0,  0,  0,  0,  0,  0,  0,  0,  0,  0,  0,  0,  0,  0,  0],
         [  0,  0,  0,  0,  0,  0,  0,  0,  0,  0,  0,  0,  0,  0,  0,  0,  0,  0,  0,  0],
         [  0,  0,  0,  0,  0,  0,  0,  0,  0,  0,  0,  0,  0,  0,  0,  0,  0,  0,  0,  0],
         [  0,  0,  0,  0,  0,  0,  0,  0,  0,  0,  0,  0,  0,  0,  0,  0,  0,  0,  0,  0],
         [  0,  0,  0,  0,  0,  0,  0,  0,  0,  0,  0,  0,  0,  0,  0,  0,  0,  0,  0,  0],
         [  0,  0,  0,  0,  0,  0,  0,  0,  0,  0,  0,  0,  0,  0,  0,  0,  0,  0,  0,  0]],
    "eventsActions": 
        {
        "1": 
            [["showText","This text has more characters than it's allowed.\nI want to see if the splitting is right.\n46.\n39.\nThose were the characters numbers."]],
        "3": 
            [["showText","This locker is empty"]],
        "2": 
            [["showText","Hello World!"]],
        "5": 
            [["showText","maninhaaa!!!"],
             ["fadeOut","pixelizeFadeOut;doNotKeep"],
             ["teleport","10;5;insideLevel0"]],
        "4": 
            [["fadeOut","whiteFadeOut;keepEffect"],
             ["teleport","8;7;insideLevel0"],
             ["fadeIn","whiteFadeIn;doNotKeep"]],
        "6": 
            [["teleport","4;4;level1"]]
        },
    "colision": 
        [[  0,  0,  0,  0,  0,  0,  0,  0,  0,  0,  0,  0,  0,  0,  0,  0,  0,  0,  1,  1],
         [  0,  0,  0,  0,  0,  0,  0,  0,  0,  0,  0,  0,  0,  0,  0,  0,  0,  1,  1,  1],
         [  0,  0,  0,  0,  0,  0,  0,  0,  0,  0,  0,  0,  0,  0,  0,  0,  1,  1,  1,  1],
         [  0,  0,  0,  0,  0,  0,  0,  0,  0,  0,  0,  0,  1,  1,  1,  1,  1,  1,  1,  1],
         [  0,  0,  0,  0,  0,  0,  0,  0,  0,  0,  0,  0,  0,  0,  1,  1,  1,  1,  1,  1],
         [  0,  0,  0,  1,  1,  1,  0,  0,  0,  0,  0,  0,  0,  0,  0,  1,  1,  1,  1,  1],
         [  0,  0,  0,  1,  1,  1,  0,  0,  0,  0,  0,  0,  0,  0,  0,  1,  1,  1,  1,  1],
         [  0,  0,  0,  1,  1,  1,  0,  0,  0,  0,  0,  0,  0,  0,  0,  0,  1,  1,  1,  1],
         [  0,  0,  0,  1,  0,  1,  0,  0,  0,  0,  0,  0,  0,  0,  0,  0,  0,  1,  1,  1],
         [  0,  0,  0,  0,  0,  0,  0,  0,  0,  1,  0,  0,  0,  0,  0,  0,  0,  1,  1,  1],
         [  0,  0,  0,  0,  0,  0,  0,  0,  0,  0,  0,  0,  0,  0,  0,  0,  0,  1,  1,  1],
         [  0,  0,  0,  0,  0,  0,  0,  0,  0,  0,  0,  0,  0,  0,  0,  0,  0,  0,  1,  1],
         [  0,  0,  0,  0,  0,  0,  1,  1,  1,  0,  0,  1,  0,  0,  0,  0,  0,  0,  1,  1],
         [  0,  0,  0,  0,  0,  0,  1,  1,  1,  0,  1,  1,  1,  0,  0,  0,  0,  1,  1,  1],
         [  0,  0,  0,  0,  0,  0,  1,  1,  1,  0,  0,  1,  0,  0,  0,  0,  1,  1,  1,  1],
         [  0,  0,  0,  0,  0,  0,  1,  1,  1,  0,  0,  0,  0,  0,  0,  1,  1,  1,  1,  1],
         [  0,  0,  0,  0,  0,  0,  1,  0,  1,  0,  0,  0,  0,  0,  0,  1,  1,  1,  1,  1],
         [  0,  0,  0,  0,  0,  0,  0,  0,  0,  0,  0,  0,  0,  0,  0,  1,  1,  1,  1,  1],
         [  0,  0,  0,  0,  0,  0,  0,  0,  0,  0,  0,  0,  0,  0,  1,  1,  1,  1,  1,  1],
         [  0,  0,  0,  0,  0,  0,  0,  0,  0,  0,  0,  0,  0,  0,  1,  1,  1,  1,  1,  1]],
    "eventsType": 
        {
        "1":  [  1,  0],
        "3":  [  1,  0],
        "2":  [  1,  0],
        "5":  [  0,  1],
        "4":  [  0,  1],
        "6":  [  0,  1]
        },
    "events": 
        [[  0,  0,  0,  0,  0,  0,  0,  0,  0,  0,  0,  0,  0,  0,  0,  0,  0,  0,  0,  0],
         [  0,  0,  0,  0,  0,  0,  0,  0,  0,  0,  0,  0,  0,  0,  0,  0,  0,  0,  0,  0],
         [  0,  0,  6,  0,  0,  0,  0,  0,  0,  0,  0,  0,  0,  0,  0,  0,  0,  0,  0,  0],
         [  0,  0,  0,  0,  0,  0,  0,  0,  0,  0,  0,  0,  0,  0,  0,  0,  0,  0,  0,  0],
         [  0,  0,  0,  0,  0,  0,  0,  0,  0,  0,  0,  0,  0,  0,  0,  0,  0,  0,  0,  0],
         [  0,  0,  0,  0,  0,  0,  0,  0,  0,  0,  0,  0,  0,  0,  0,  0,  0,  0,  0,  0],
         [  0,  0,  0,  0,  0,  0,  0,  0,  0,  0,  0,  0,  0,  0,  0,  0,  0,  0,  0,  0],
         [  0,  0,  0,  0,  0,  0,  0,  0,  0,  0,  0,  0,  0,  0,  0,  0,  0,  0,  0,  0],
         [  0,  0,  0,  0,  4,  0,  0,  0,  0,  0,  0,  0,  0,  0,  0,  0,  0,  0,  0,  0],
         [  0,  0,  0,  0,  0,  0,  0,  0,  0,  2,  0,  0,  0,  0,  0,  0,  0,  0,  0,  0],
         [  0,  0,  0,  0,  0,  0,  0,  0,  0,  0,  0,  0,  0,  0,  0,  0,  0,  0,  0,  0],
         [  0,  0,  0,  0,  0,  0,  0,  0,  0,  0,  0,  0,  0,  0,  0,  0,  0,  0,  0,  0],
         [  0,  0,  0,  0,  0,  0,  0,  0,  0,  0,  0,  1,  0,  0,  0,  0,  0,  0,  0,  0],
         [  0,  0,  0,  0,  0,  0,  0,  0,  0,  0,  1,  0,  1,  0,  0,  0,  0,  0,  0,  0],
         [  0,  0,  0,  0,  0,  0,  0,  0,  0,  0,  0,  1,  0,  0,  0,  0,  0,  0,  0,  0],
         [  0,  0,  0,  0,  0,  0,  0,  0,  0,  0,  0,  0,  0,  0,  0,  0,  0,  0,  0,  0],
         [  0,  0,  0,  0,  0,  0,  0,  0,  0,  0,  0,  0,  0,  0,  0,  0,  0,  0,  0,  0],
         [  0,  0,  0,  0,  0,  0,  0,  0,  0,  0,  0,  0,  0,  0,  0,  0,  0,  0,  0,  0],
         [  0,  0,  0,  0,  0,  0,  0,  0,  0,  0,  0,  0,  0,  0,  0,  0,  0,  0,  0,  0],
         [  0,  0,  0,  0,  0,  0,  0,  0,  0,  0,  0,  0,  0,  0,  0,  0,  0,  0,  0,  0]]
    }
}